# Map size:
# 32,32
# Map:
# Whitespace=Empty (Non-block)
# Blocks: T=Tree, R=Rock, W=Water
TTTTTTTTTTTTTTTTTTTTTTTTTTTTTTTT
T   TT                    TT   T
TT                        T    T
T                              T
T   WWW                        T
T   WWWW                WWWWW  T
T   WWWWW              WWWWW   T
T    WWWW  T        T          T
T     WW   T        T          T
T         TT        TT         T
T        TT          TT        T
T      TTT   R    R   TTT      T
T            R    R            T
T          RRR    RRR     T    T
T                         TT   T
T                         T    T
T    T                         T
T   TT                         T
T    T     RRR    RRR          T
T            R    R            T
T      TTT   R    R   TTT      T
T        TT          TT        T
T         TT        TT         T
T          T        T   WW     T
T          T        T  WWWW    T
T   WWWWW              WWWWW   T
T  WWWWW                WWWW   T
T                        WWW   T
T                             TT
T    T                         T
T   TT                    TT   T
TTTTTTTTTTTTTTTTTTTTTTTTTTTTTTTT
